i= 0 j= 0
9 i= 1 j= 1
7 i= 2 j= 2
6 i= 3 j= 4
8 i= 4 j= 5
8 i= 5 j= 5
8 i= 6 j= 6
5 